[console_scripts]
nb-export = nbdev.cli:nb_export_cli
nbdev-bump-version = nbdev.release:nbdev_bump_version
nbdev-changelog = nbdev.release:changelog
nbdev-clean = nbdev.clean:nbdev_clean
nbdev-conda = nbdev.release:release_conda
nbdev-contributing = nbdev.quarto:nbdev_contributing
nbdev-create-config = nbdev.config:nbdev_create_config
nbdev-docs = nbdev.quarto:nbdev_docs
nbdev-export = nbdev.doclinks:nbdev_export
nbdev-filter = nbdev.cli:nbdev_filter
nbdev-fix = nbdev.merge:nbdev_fix
nbdev-help = nbdev.cli:chelp
nbdev-install = nbdev.quarto:install
nbdev-install-hooks = nbdev.clean:nbdev_install_hooks
nbdev-install-quarto = nbdev.quarto:install_quarto
nbdev-merge = nbdev.merge:nbdev_merge
nbdev-migrate = nbdev.migrate:nbdev_migrate
nbdev-migrate-config = nbdev.migrate:nbdev_migrate_config
nbdev-new = nbdev.cli:nbdev_new
nbdev-prepare = nbdev.quarto:prepare
nbdev-preview = nbdev.quarto:nbdev_preview
nbdev-proc-nbs = nbdev.quarto:nbdev_proc_nbs
nbdev-pypi = nbdev.release:release_pypi
nbdev-readme = nbdev.quarto:nbdev_readme
nbdev-release-both = nbdev.release:release_both
nbdev-release-gh = nbdev.release:release_gh
nbdev-release-git = nbdev.release:release_git
nbdev-requirements = nbdev.release:write_requirements
nbdev-sidebar = nbdev.quarto:nbdev_sidebar
nbdev-test = nbdev.test:nbdev_test
nbdev-trust = nbdev.clean:nbdev_trust
nbdev-update = nbdev.sync:nbdev_update
nbdev-update-license = nbdev.cli:nbdev_update_license
watch-export = nbdev.cli:watch_export

[nbdev]
nbdev = nbdev._modidx:d
