[console_scripts]
iolanta=iolanta.cli:app
iolanta-mcp=iolanta.mcp.cli:app
sparqlspace=iolanta.sparqlspace.cli:app

[iolanta.facets]
ask-result-csv-facet=iolanta.facets.query.ask_result_csv:AskResultCsvFacet
ask-result-json-facet=iolanta.facets.query.ask_result_json:AskResultJsonFacet
ask-result-table-facet=iolanta.facets.query.ask_result_table:AskResultTableFacet
boolean=iolanta.facets.generic:BoolLiteral
construct-result-csv-facet=iolanta.facets.query.construct_result_csv:ConstructResultCsvFacet
construct-result-json-facet=iolanta.facets.query.construct_result_json:ConstructResultJsonFacet
construct-result-table-facet=iolanta.facets.query.construct_result_table:ConstructResultTableFacet
icon=iolanta.facets.icon:IconFacet
labeled-triple-set=iolanta.labeled_triple_set.labeled_triple_set:LabeledTripleSet
mermaid-graph=iolanta.mermaid.facet:Mermaid
mermaid-roadmap=iolanta.facets.mermaid_roadmap.facet:MermaidRoadmap
mkdocs-material-insiders-markdown-datatype=iolanta.facets.mkdocs_material_insiders_markdown:MkDocsMaterialInsidersMarkdownFacet
qname=iolanta.facets.qname:QNameFacet
rich-declension-table=iolanta.declension.facet:RichDeclensionTable
select-result-csv-facet=iolanta.facets.query.select_result_csv:SelectResultCsvFacet
select-result-json-facet=iolanta.facets.query.select_result_json:SelectResultJsonFacet
select-result-table-facet=iolanta.facets.query.select_result_table:SelectResultTableFacet
textual-browser=iolanta.facets.textual_browser:TextualBrowserFacet
textual-class=iolanta.facets.textual_class:Class
textual-graph=iolanta.facets.textual_graph:GraphFacet
textual-graph-triples=iolanta.facets.textual_graph_triples:GraphTriplesFacet
textual-graphs=iolanta.facets.textual_graphs:Graphs
textual-inverse-properties=iolanta.facets.textual_default:InverseProperties
textual-link=iolanta.facets.textual_link:TextualLinkFacet
textual-nanopublication=iolanta.facets.textual_nanopublication:NanopublicationFacet
textual-no-facet-found=iolanta.facets.textual_no_facet_found:TextualNoFacetFound
textual-ontology=iolanta.facets.textual_ontology:OntologyFacet
textual-properties=iolanta.facets.textual_default:TextualDefaultFacet
textual-property-pairs=iolanta.facets.textual_property_pairs_table:TextualPropertyPairsTableFacet
textual-provenance=iolanta.facets.textual_provenance:TextualProvenanceFacet
title=iolanta.facets.title:TitleFacet
title-foaf-person=iolanta.facets.foaf_person_title:FOAFPersonTitle

[iolanta.plugins]
base=iolanta:IolantaBase

[rdf.plugins.queryprocessor]
sparqlspace=iolanta.sparqlspace.processor:GlobalSPARQLProcessor

