[console_scripts]
clang-tool-chain = clang_tool_chain.cli:main
clang-tool-chain-ar = clang_tool_chain.wrapper:llvm_ar_main
clang-tool-chain-as = clang_tool_chain.wrapper:llvm_as_main
clang-tool-chain-build = clang_tool_chain.wrapper:build_main
clang-tool-chain-build-run = clang_tool_chain.wrapper:build_run_main
clang-tool-chain-c = clang_tool_chain.wrapper:clang_main
clang-tool-chain-c-msvc = clang_tool_chain.wrapper:clang_msvc_main
clang-tool-chain-cosmocc = clang_tool_chain.wrapper:cosmocc_main
clang-tool-chain-cosmocpp = clang_tool_chain.wrapper:cosmocpp_main
clang-tool-chain-cpp = clang_tool_chain.wrapper:clang_cpp_main
clang-tool-chain-cpp-msvc = clang_tool_chain.wrapper:clang_cpp_msvc_main
clang-tool-chain-dis = clang_tool_chain.wrapper:llvm_dis_main
clang-tool-chain-emar = clang_tool_chain.wrapper:emar_main
clang-tool-chain-emcc = clang_tool_chain.wrapper:emcc_main
clang-tool-chain-empp = clang_tool_chain.wrapper:empp_main
clang-tool-chain-fetch = clang_tool_chain.fetch:main
clang-tool-chain-fix-includes = clang_tool_chain.wrapper:fix_includes_main
clang-tool-chain-format = clang_tool_chain.wrapper:clang_format_main
clang-tool-chain-iwyu = clang_tool_chain.wrapper:iwyu_main
clang-tool-chain-iwyu-tool = clang_tool_chain.wrapper:iwyu_tool_main
clang-tool-chain-ld = clang_tool_chain.wrapper:lld_main
clang-tool-chain-lldb = clang_tool_chain.wrapper:lldb_main
clang-tool-chain-lldb-check-python = clang_tool_chain.wrapper:lldb_check_python_main
clang-tool-chain-meson = clang_tool_chain.wrapper:meson_main
clang-tool-chain-nm = clang_tool_chain.wrapper:llvm_nm_main
clang-tool-chain-objcopy = clang_tool_chain.wrapper:llvm_objcopy_main
clang-tool-chain-objdump = clang_tool_chain.wrapper:llvm_objdump_main
clang-tool-chain-paths = clang_tool_chain.paths:main
clang-tool-chain-ranlib = clang_tool_chain.wrapper:llvm_ranlib_main
clang-tool-chain-readelf = clang_tool_chain.wrapper:llvm_readelf_main
clang-tool-chain-run = clang_tool_chain.wrapper:run_main
clang-tool-chain-sccache = clang_tool_chain.cli:sccache_main
clang-tool-chain-sccache-c = clang_tool_chain.cli:sccache_c_main
clang-tool-chain-sccache-c-msvc = clang_tool_chain.cli:sccache_c_msvc_main
clang-tool-chain-sccache-cpp = clang_tool_chain.cli:sccache_cpp_main
clang-tool-chain-sccache-cpp-msvc = clang_tool_chain.cli:sccache_cpp_msvc_main
clang-tool-chain-sccache-emcc = clang_tool_chain.wrapper:sccache_emcc_main
clang-tool-chain-sccache-empp = clang_tool_chain.wrapper:sccache_empp_main
clang-tool-chain-strip = clang_tool_chain.wrapper:llvm_strip_main
clang-tool-chain-test = clang_tool_chain.cli:test_main
clang-tool-chain-tidy = clang_tool_chain.wrapper:clang_tidy_main
clang-tool-chain-wasm-ld = clang_tool_chain.wrapper:wasm_ld_main
